################
#.I.......M....#
#..............#
#....I...I.....#
#.........######
#..M...........#
#.......M....M.#
#..#.......I...#
#..#.......I...#
#.##...A...I...#
#..........I...#
################
