################
#.........M....#
#..............#
#....I.........#
#.........######
#..M...........#
#.......M....M.#
#..#.......I...#
#..#.......I...#
#.##...A...I...#
#..........I...#
################
